####################
#S0000000000#00000##
#0#0#######0#0######
#0#0000000#0000000##
#0#0#0##############
#0#0#0000000000000##
#0#0#0###0#0########
#0#0#000#0#0000000##
#0#0#0#0###0########
#0#0#0#000#0000000##
#0#0#0#0###0#0#0#0##
#0#0#0#000#0#0#0#0##
#0###0#0#0#0#0#0#0##
#000#0#0#0#0#0#0#0##
#0###0#0#0###0#0####
#000#0#0#000#0#0#0##
#0###0###0#0#0###0##
#000#000#0#0#0000F##
####################
####################
